2222222222222222222222222222222222222222222222222222222222222222222222222222222222
2000000000000000000000000000000000000000000000000000000000000000000000000000000002
2000000000000000000000000000000000000000000000000000000000000000000000000000000002
2000000000000000000000000000000000000000000000000000000000000000000000000000000002
2000001100000000000000000000000000000000000000001100000000000000000000000000000002
2000000110000000000111111111100000000000000000011000000000000000000000000000000002
2000000011000000000000000000000000000000000000110000000010000000000000000000000002
2000000001100000000000000000000000000000000001100000000010000000000000000000000002
2000000000110000000000000000000000000000000011000000000010000000000011111000000002
2000000000011000000000000000000000000000000110000000000010000000000001000000000002
2000000000001100000000000000000000000000001100000000000010000000000001000000000002
2000000000000111111111111111000001111111111100000001111110000000000001000000000002
2000000000000000000000001000000000000000000000000000000100000000000001000000000002
2000000000000000000000001000000000000000000000000000000100000000000001000000000002
2000000000000000000000001000000000000000000000000000000100000000000001000000000002
2000111111111100000000001000000000000000000000000000000000000000000001000000000002
2000000000000000000000001000000000000000000000000000000000000000000000000000000002
2000000000000000000000001000000000000000000000000000000000000000000000000000000002
2000000000000000000000001000011111111111111111111111111111111110000000000000000002
2000000000000000000000001000000000000000000100000000000000000000000000000000000002
2000000000000000000000001000000000000000000100000000000000000000000000000000000002
2000000000000000000000001000000000000000000100000000000000000000000000000000000002
2000000000000000000000000000000000000000000100000000000000000000000000000000000002
2000000000000000000000000000000000000000000100000000000000000010000000000000000002
2000000000000000000000000000000000000000000100000000000000000010000111000000000002
2000000000000000000000000000000000000000000100000000000000000010000000000000000002
2000000011111111111111111000000000000000000100000000000000000010000000000000000002
2000000000000000000000001100000000000000000100000000000000000010000000001110000002
2000000000000000000000000110000000000000000100000000000000000010000000000000000002
2000000000000000000000000011000000000000000100000000000000000010000000000000000002
2000000000000000000000000001100000000000000100000000000000000010000000000000000002
2000011100000000000000000000110000000000000100000000000000000010000000000000000002
2000000000001110000000000000000000000000000000000000000000000010000001110000000002
2000000000000000000000000000000000000000000000000000000000000000000000000000000002
2000000000000000000000000000000000000000000000000000000000000000000000000000000002
2000000000000000000000000000000000000000000000000000000000000000000000000000000002
2222222222222222222222222222222222222222222222222222222222222222222222222222222222