1111111111111111111111111111111111111111111111111111111111111111111111111111111111
1000000000000000000000000000000000000000000000000000000000000000000000000000000001
1000000000000000000000000000000000000000000000000000000000000000000000000000000001
1000000000000000000000000000000000000000000000000000000000000000000000000000000001
1000001111111111111111111111111111111111110000000000000000000000001000000000000001
1000000000000000000000000000000000000000000000000000000000000000001000000000000001
1000000000000000000000000000000000000000000000000000000000000000001000000000000001
1000000000000000000000000000000000000000000000000000000000000000001000000000000001
1000000000000001000000111111111111111111111111111100000000000000001000000000000001
1000000000000001000000000000000000001000000000000000000000000000001000000000000001
1000000000000001000000000000000000001000000000000000000000000000001000000000000001
1000000000000001000000000000000000001000000000000000000000000000001000000000000001
1000000000000001000000000000000000001000000000000000000000000000001000000000000001
1000000000000001000000000000000000001000000000000000000000000000001000000000000001
1000000000000001000000000000000000001000000000000000000000000000001000000000000001
1000000000000001000000000000000000001000000000000000000000000000001000000000000001
1000000000000001000000001000000000001000000000000000000000000000001000000000000001
1000011111000001000000001000000000001000000000000000000000000000001000000000000001
1000011111000001000000001000000000001111111111111110000011111111111111111110000001
1000011111000001000000001000000000001000000000000000000000000000000000000000000001
1000000000000001000000001000000000001000000000000000000000000000000000000000000001
1000000000000001000000001000000000001000000000000000000000000000000000000000000001
1000000000000001000000001000000000001000000000000000000000000001000000000000000001
1000000000000001000000000000000000001000000000000000000000000001000000000000000001
1000000000000001000000000000000000001000000000000000000000000001000000000000000001
1000000000000001000000000000000000001000000000000000000000000001000000000000000001
1000000000000001000000000000000000001000000000000000000000000001000000000000000001
1000000000000001000000000000000000001000000000000000000000000000000000000000000001
1000000000000001000000000000000000001000000000000000000000000000000000000000000001
1000000000000000000000000000000000000000000000000000000000000000000000000000000001
1000000000000000000000000000000000000000000000001111111111111111111111100000000001
1000000000000000000000000000000000000000000000000000000000000000000000000000000001
1000001111111111111111111111111111111111100000000000000000000000000000000000000001
1000000000000000000000000000000000000000000000000000000000000000000000000000000001
1000000000000000000000000000000000000000000000000000000000000000000000000000000001
1000000000000000000000000000000000000000000000000000000000000000000000000000000001
1111111111111111111111111111111111111111111111111111111111111111111111111111111111