222222222222222222222222222222222222222222222222
200000100000011000010000000000000001000000000002
200000100000000000010000000000000001000000000002
200000100000000000010000000010000001000000000002
200001100000000000010000000010000001000000000002
200000000011110000010000000010000001000000000002
200000000110000000010000000010000001000000000002
200000001100000000010000000010000000000000000002
211111111111111000011000000010000000000000000002
200000000000001000001000011111111111111111111112
200000000000001000001000000000000000010000000002
200000000000001000001000000000000000010000000002
200000100000001000001000000000000000010000100002
200000100000001000001111111111100000010000100002
200000100000001000001000000000000000000000100002
200000100000001000001000000000000000000000100002
200000100000001000001000000001111111111111111112
200000100000001000000000000000000000000000000002
200000100000001000000000000000000000000000000002
200000100000001111111111111111110000001000000002
200000100010001000000010000000000000001000000002
200000100010001000000011000000000000001000000002
200000100010001000000011111111111000001001111112
200000100000001000000010000001000000001000000002
200000100000000000000010000001000000001000000002
200000100000000000000000000000000000001000000002
200000100000000000000000000000000000001000000002
222222222222222222222222222222222222222222222222